Actinium	Actinoids
Aluminum	Post-Transition-Metal
Americium	Actinoids
Antimony	Metalloid
Argon	Noble-Gases
Arsenic	Metalloid
Astatine	Metalloid
Barium	Alkaline-Earth-Metals
Berkelium	Actinoids
Beryllium	Alkaline-Earth-Metals
Bismuth	Post-Transition-Metal
Boron	Metalloid
Bromine	Halogen
Cadmium	Transition-Metal
Calcium	Alkaline-Earth-Metals
Californium	Actinoids
Carbon	Non-Metal
Cerium	Lanthanoids
Caesium	Alkali-Metals
Chlorine	Halogen
Chromium	Transition-Metal
Cobalt	Transition-Metal
Copper	Transition-Metal
Curium	Actinoids
Dysprosium	Lanthanoids
Einsteinium	Actinoids
Erbium	Lanthanoids
Europium	Lanthanoids
Fermium	Actinoids
Fluorine	Halogen
Francium	Alkali-Metals
Gadolinium	Lanthanoids
Gallium	Post-Transition-Metal
Germanium	Metalloid
Gold	Transition-Metal
Hafnium	Transition-Metal
Helium	Noble-Gases
Holmium	Lanthanoids
Hydrogen	Non-Metal
Indium	Post-Transition-Metal
Iodine	Halogen
Iridium	Transition-Metal
Iron	Transition-Metal
Krypton	Noble-Gases
Lanthanum	Lanthanoids
Lawrencium	Actinoids
Lead	Post-Transition-Metal
Lithium	Alkali-Metals
Lutetium	Lanthanoids
Magnesium	Alkaline-Earth-Metals
Manganese	Transition-Metal
Mendelevium	Actinoids
Mercury	Transition-Metal
Molybdenum	Transition-Metal
Neodymium	Lanthanoids
Neon	Noble-Gases
Neptunium	Actinoids
Nickel	Transition-Metal
Niobium	Transition-Metal
Nitrogen	Non-Metal
Nobelium	Actinoids
Osmium	Transition-Metal
Oxygen	Non-Metal
Palladium	Transition-Metal
Phosphorus	Non-Metal
Platinum	Transition-Metal
Plutonium	Actinoids
Polonium	Post-Transition-Metal
Potassium	Alkali-Metals
Praseodymium	Lanthanoids
Promethium	Lanthanoids
Protactinium	Actinoids
Radium	Alkaline-Earth-Metals
Radon	Noble-Gases
Rhenium	Transition-Metal
Rhodium	Transition-Metal
Rubidium	Alkali-Metals
Ruthenium	Transition-Metal
Rutherfordium	Transition-Metal
Samarium	Lanthanoids
Scandium	Transition-Metal
Selenium	Non-Metal
Silicon	Non-Metal
Silver	Transition-Metal
Sodium	Alkali-Metals
Strontium	Alkaline-Earth-Metals
Sulfur	Non-Metal
Tantalum	Transition-Metal
Technetium	Transition-Metal
Tellurium	Metalloid
Terbium	Lanthanoids
Thallium	Post-Transition-Metal
Thorium	Actinoids
Thulium	Lanthanoids
Tin	Post-Transition-Metal
Titanium	Transition-Metal
Tungsten	Transition-Metal
Uranium	Actinoids
Vanadium	Transition-Metal
Xenon	Noble-Gases
Ytterbium	Lanthanoids
Yttrium	Transition-Metal
Zinc	Transition-Metal
Zirconium	Transition-Metal